number: 1, energy_per_step: 10, whole_energy: 250, goal: 10, width: 20, hieght: 20
o1_o1_o1_o1_o1_w0_w0_o1_o1_o1_o1_o1_o1_o1_o1_o1_o1_o1_o1_o1
g0_g0_o1_o1_o1_o1_w0_w0_o1_o1_o1_o1_o1_o1_o1_o1_o1_o1_g5_g5
g0_g0_g0_o1_o1_o1_o1_w0_w0_o1_o1_o1_o1_o1_o1_o1_o1_o1_o1_g5
g0_g0_o1_o1_o1_o1_o1_w0_w0_w0_w0_w0_w0_w0_w0_w0_o1_o1_o1_g5
g0_o1_o1_o1_o1_w0_w0_w0_w0_w0_w0_w0_w0_w0_w0_w0_w0_o1_o1_g5
g0_g0_o1_o1_o1_o1_w0_w0_w0_w0_w0_w0_w0_w0_w0_w0_o1_o1_o1_g5
g0_g0_g0_o1_o1_o1_o1_o1_o1_o1_g0_o1_o1_o1_o1_o1_o1_o1_o1_g5
g0_g0_g0_g0_o1_o1_o1_o1_o1_o1_o0_o1_o1_o1_o1_o1_o1_o1_g5_g5
g0_g0_g0_g0_g0_g0_g0_g0_g0_g0_g0_g5_g5_g5_g5_g5_g5_g5_g5_g5
g0_g0_g0_g0_g0_g0_g0_g0_g0_g0_g0_g0_g5_g5_f0_o0_o0_o0_f0_f0
g0_g0_g0_g0_g0_g0_g0_g0_g0_b0_g1_g0_o2_f0_f0_o0_o0_o0_o0_f0
g0_g0_g0_g0_g0_g0_g0_g0_g0_g0_g0_g0_f0_f0_f0_o0_o0_o0_f0_f0
g0_g0_g0_g0_g0_g0_g0_g0_g0_g0_g0_g0_g0_f0_f0_f0_f0_f0_f0_f0
g0_f1_f1_f1_f1_f1_f1_f1_g0_g0_g0_g0_g0_g0_f0_f0_f0_f0_f0_f0
f1_f1_f1_f1_f1_f1_f1_f1_f1_g0_g0_g0_g0_g0_g0_f0_f0_f0_f0_f0
f1_f1_f1_f1_f1_f1_f1_f1_f1_f1_g0_g0_g0_g0_g0_f0_f0_f0_f0_f0
f1_f1_f1_f1_f1_f1_f1_f1_f1_f1_o3_o3_o3_o3_o3_o3_o3_o3_o3_o3
f1_f1_f1_f1_f1_f1_f1_f1_w0_w0_w0_w0_w0_w0_w0_w0_w0_w0_w0_w0
f1_f1_f1_f1_f1_f1_f1_w0_w0_w0_w0_w0_w0_w0_w0_w0_w0_w0_w0_w0
f1_f1_f1_f1_f1_f1_w0_w0_w0_w0_w0_w0_w0_w0_w0_w0_w0_w0_w0_w0